"filename", "language", "JavaScript", "HTML", "Handlebars", "JSON", "CSS", "comment", "blank", "total"
"e:\My Projects\Invoice App\Early Build\Alpha Version\Back End\Invoice-App-Back-End\.puppeteerrc.cjs", "JavaScript", 4, 0, 0, 0, 0, 4, 1, 9
"e:\My Projects\Invoice App\Early Build\Alpha Version\Back End\Invoice-App-Back-End\Controllers\AccountUserController.js", "JavaScript", 3, 0, 0, 0, 0, 0, 1, 4
"e:\My Projects\Invoice App\Early Build\Alpha Version\Back End\Invoice-App-Back-End\Controllers\CustomerController.js", "JavaScript", 128, 0, 0, 0, 0, 0, 12, 140
"e:\My Projects\Invoice App\Early Build\Alpha Version\Back End\Invoice-App-Back-End\Controllers\InvoiceController.js", "JavaScript", 179, 0, 0, 0, 0, 43, 21, 243
"e:\My Projects\Invoice App\Early Build\Alpha Version\Back End\Invoice-App-Back-End\Controllers\ProductController.js", "JavaScript", 87, 0, 0, 0, 0, 1, 8, 96
"e:\My Projects\Invoice App\Early Build\Alpha Version\Back End\Invoice-App-Back-End\Controllers\QuotationController.js", "JavaScript", 222, 0, 0, 0, 0, 11, 24, 257
"e:\My Projects\Invoice App\Early Build\Alpha Version\Back End\Invoice-App-Back-End\Controllers\TransactionDetailController.js", "JavaScript", 102, 0, 0, 0, 0, 7, 11, 120
"e:\My Projects\Invoice App\Early Build\Alpha Version\Back End\Invoice-App-Back-End\Controllers\index.js", "JavaScript", 14, 0, 0, 0, 0, 0, 2, 16
"e:\My Projects\Invoice App\Early Build\Alpha Version\Back End\Invoice-App-Back-End\Helpers.js", "JavaScript", 102, 0, 0, 0, 0, 0, 15, 117
"e:\My Projects\Invoice App\Early Build\Alpha Version\Back End\Invoice-App-Back-End\Middlewares\ApplicationLevelAuthentication.js", "JavaScript", 3, 0, 0, 0, 0, 1, 1, 5
"e:\My Projects\Invoice App\Early Build\Alpha Version\Back End\Invoice-App-Back-End\Middlewares\InvoiceAggregate.js", "JavaScript", 6, 0, 0, 0, 0, 3, 2, 11
"e:\My Projects\Invoice App\Early Build\Alpha Version\Back End\Invoice-App-Back-End\Middlewares\QuotationAggregate.js", "JavaScript", 6, 0, 0, 0, 0, 2, 2, 10
"e:\My Projects\Invoice App\Early Build\Alpha Version\Back End\Invoice-App-Back-End\Middlewares\index.js", "JavaScript", 10, 0, 0, 0, 0, 0, 2, 12
"e:\My Projects\Invoice App\Early Build\Alpha Version\Back End\Invoice-App-Back-End\Models\CustomerModel.js", "JavaScript", 35, 0, 0, 0, 0, 0, 4, 39
"e:\My Projects\Invoice App\Early Build\Alpha Version\Back End\Invoice-App-Back-End\Models\InvoiceModel.js", "JavaScript", 49, 0, 0, 0, 0, 0, 6, 55
"e:\My Projects\Invoice App\Early Build\Alpha Version\Back End\Invoice-App-Back-End\Models\ProductModel.js", "JavaScript", 12, 0, 0, 0, 0, 0, 4, 16
"e:\My Projects\Invoice App\Early Build\Alpha Version\Back End\Invoice-App-Back-End\Models\QuotationModel.js", "JavaScript", 43, 0, 0, 0, 0, 0, 5, 48
"e:\My Projects\Invoice App\Early Build\Alpha Version\Back End\Invoice-App-Back-End\Models\TransactionDetailModel.js", "JavaScript", 25, 0, 0, 0, 0, 0, 4, 29
"e:\My Projects\Invoice App\Early Build\Alpha Version\Back End\Invoice-App-Back-End\Models\index.js", "JavaScript", 12, 0, 0, 0, 0, 0, 2, 14
"e:\My Projects\Invoice App\Early Build\Alpha Version\Back End\Invoice-App-Back-End\Routers\AccountUserRouter.js", "JavaScript", 5, 0, 0, 0, 0, 0, 3, 8
"e:\My Projects\Invoice App\Early Build\Alpha Version\Back End\Invoice-App-Back-End\Routers\CustomerRouter.js", "JavaScript", 22, 0, 0, 0, 0, 5, 8, 35
"e:\My Projects\Invoice App\Early Build\Alpha Version\Back End\Invoice-App-Back-End\Routers\InvoiceRouter.js", "JavaScript", 26, 0, 0, 0, 0, 8, 10, 44
"e:\My Projects\Invoice App\Early Build\Alpha Version\Back End\Invoice-App-Back-End\Routers\ProductRouter.js", "JavaScript", 13, 0, 0, 0, 0, 5, 8, 26
"e:\My Projects\Invoice App\Early Build\Alpha Version\Back End\Invoice-App-Back-End\Routers\QuotationRouter.js", "JavaScript", 31, 0, 0, 0, 0, 9, 12, 52
"e:\My Projects\Invoice App\Early Build\Alpha Version\Back End\Invoice-App-Back-End\Routers\TransactionDetailRouter.js", "JavaScript", 25, 0, 0, 0, 0, 5, 8, 38
"e:\My Projects\Invoice App\Early Build\Alpha Version\Back End\Invoice-App-Back-End\Routers\index.js", "JavaScript", 14, 0, 0, 0, 0, 0, 2, 16
"e:\My Projects\Invoice App\Early Build\Alpha Version\Back End\Invoice-App-Back-End\data.js", "JavaScript", 46, 0, 0, 0, 0, 21, 5, 72
"e:\My Projects\Invoice App\Early Build\Alpha Version\Back End\Invoice-App-Back-End\generatePdf.js", "JavaScript", 61, 0, 0, 0, 0, 1, 18, 80
"e:\My Projects\Invoice App\Early Build\Alpha Version\Back End\Invoice-App-Back-End\html_templates\first.css", "CSS", 0, 0, 0, 0, 216, 0, 43, 259
"e:\My Projects\Invoice App\Early Build\Alpha Version\Back End\Invoice-App-Back-End\html_templates\first.html", "HTML", 0, 133, 0, 0, 0, 0, 1, 134
"e:\My Projects\Invoice App\Early Build\Alpha Version\Back End\Invoice-App-Back-End\index.js", "JavaScript", 113, 0, 0, 0, 0, 7, 29, 149
"e:\My Projects\Invoice App\Early Build\Alpha Version\Back End\Invoice-App-Back-End\package-lock.json", "JSON", 0, 0, 0, 3541, 0, 0, 1, 3542
"e:\My Projects\Invoice App\Early Build\Alpha Version\Back End\Invoice-App-Back-End\package.json", "JSON", 0, 0, 0, 26, 0, 0, 1, 27
"e:\My Projects\Invoice App\Early Build\Alpha Version\Back End\Invoice-App-Back-End\templates\first.css", "CSS", 0, 0, 0, 0, 216, 0, 43, 259
"e:\My Projects\Invoice App\Early Build\Alpha Version\Back End\Invoice-App-Back-End\templates\first.html", "HTML", 0, 133, 0, 0, 0, 0, 1, 134
"e:\My Projects\Invoice App\Early Build\Alpha Version\Back End\Invoice-App-Back-End\templates\template-1.hbs", "Handlebars", 0, 0, 12, 0, 0, 0, 0, 12
"e:\My Projects\Invoice App\Early Build\Alpha Version\Back End\Invoice-App-Back-End\templates\template-2.hbs", "Handlebars", 0, 0, 114, 0, 0, 0, 0, 114
"e:\My Projects\Invoice App\Early Build\Alpha Version\Back End\Invoice-App-Back-End\templates\template-3.hbs", "Handlebars", 0, 0, 195, 0, 0, 0, 1, 196
"e:\My Projects\Invoice App\Early Build\Alpha Version\Back End\Invoice-App-Back-End\templates\template-4.hbs", "Handlebars", 0, 0, 197, 0, 0, 0, 1, 198
"e:\My Projects\Invoice App\Early Build\Alpha Version\Back End\Invoice-App-Back-End\templates\template.html", "HTML", 0, 114, 0, 0, 0, 1, 0, 115
"Total", "-", 1398, 380, 518, 3567, 432, 134, 322, 6751